12 6 2 4 3000 0 
Level_files/Level2.txt
111111111111
100010000031
100010011111
100010011111
100020011111
111111111111
