12 8 2 2 1000 1 
Level_files/Level3.txt
111111111111
100000000001
100000000031
111000000111
101000000101
100000000001
100000000001
111111111111
