13 8 2 4 3000 0 
Level_files/Level2.txt
1111111111111
1000100000031
1000100011111
1000100011111
1000200011111
1111111111111