12 11 6 9 1000 1 
WIN
111111111111
130000000001
111100000001
100000000001
100000000001
100000000011
100000000001
111121111111
100000000001
100000000001
111111111111