030000000000
111100000000
000000000000
000000000000
000000000011
000000000000
000000000000
111121111111
000000000000
000000000000
111111111111